cenario:5
DI           4            4                                                                                                                                                                                                C
DII4         II           II                                             4                                                                                                                                                 C
DIII          II           II                                  4         II                                                                                                                                                C
D  II1         II           II                                II        II II                                                                                                                                              C
D   II          II1          II1                             II I      II   II                                                                                                                                             C
D    II          II           II                            II  II    II     II                                                4                                                                                           C
D     II1         II           II                          II     IIII        II                                              II                                                                                           C
D      II          II           II                        II                   II                                              II                                                                                          C
D       II1         II           II1                 4  III                   II                                              II                                                                I                     u    C
D        II          II           II                 IIIII                       II                                              II                                                            II          @      IIIIIIIIIC
D         II4         II           II               IIII                          II                                              II                                                          III      IIIIIIIIIII         C
D          III         II           III            II                              II                                              II                                                        IIIIIIIIII                    C
D            II         II           III          II                     3                                                          II                                                 IIIIII                              C
D             II         I            II         II                                                                                  II                                              II                                    C
D              I         I                      II                                  IIIIIIIIIIIIII                                   II                                            I                                       C
D               I         I                    II                     IIIIIIIIIIIIIII                    1             1               II                                          I                                       C
D                II        II                 II                     I                              IIIIIIIIIIIIIIIIIIIIIII             II                                              4                      4       @ * C
D                                            II                     I                                                                    IIII                 4               IIIIIIIIIII                    EBBBBBBBBBBBBBG
D                                  4        II              3      I                   ooo                                                           IIIIIIIIII                                          EBBBGAAAAAAAAAAAAAA
D                                          II                     I                                                                                                                                 EBBBBGAAAAAAAAAAAAAAAAAA
D   #      o   o   o             1        II   1                 I                      1                                        o o o               o o o                 EBBBBBBBBBBBBBBBBBBBBBBBBGAAAAAAAAAAAAAAAAAAAAAAA
HBBBBBBBBBBBBBBBBBBBBBBBBBBBBBBBBBBBBBBBBBBBBBBBBBBBBBBBBBBBBBBBBBBBBBBBBBBBBBBBBBBBBBBBBBBBBBBBBBBBBBBBBBBBBBBBBBBBBBBBBBBBBBBBBBBBBBBBBBBBBBBBBBBBBBBBBBBBBBBBBBBBBBBBBBBGAAAAAAAAAAAAAAAAAAAAAAAAAAAAAAAAAAAAAAAAAAAAAAAA