cenario:2
D                                                                                                                                                                                                                                C
D                                                                                                                                                                                                                                C
D                                                                                                                                                                                                           2                    C
D                                                                                      ! o oo o oo o o               o o o o o                                                                              IIIII                C
D                                                                                     IIIIIIIIIIIIIIIIIIII  I        IIIIIIIIIIIIII                                                          IIIIIIIIIIIIIII      IIIIIII      * C
D                                                                                                            I      I                                                                  I  I                              IIIIIIIIC
D                                                                                                             I    I                                              3                  I                                           C
D                                             2                2                                                I               o o                                                I                                             C
D                                          EBBBBBBBBBBBBBBBBBBBBBBBBBF            o o o        3                                 o                                      I  I        I             2              2               C
D                           2         EBBBBGAAAAAAAAAAAAAAAAAAAAAAAAAHBBBBF                               o o o o     2       o       o       o                        III    I  I                I              I               C
D                        EBBBBBBBBBBBBGAAAAAAAAAAAAAAAAAAAAAAAAAAAAAAAAAAAHBBBBBBBBBBBBBBBBBBBBBBF         EBBBBBBBBBBBBBBBBF                            3            IIIII                                                      C
D   #        EBBBBBBBBBBBGAAAAAAAAAAAAAAAAAAAAAAAAAAAAAAAAAAAAAAAAAAAAAAAAAAAAAAAAAAAAAAAAAAAAAAAD         CAAAAAAAAAAAAAAAAHBBBBBBBBBBBBF                           IIIIIII                                                     C
HBBBBBBBBBBBBGAAAAAAAAAAAAAAAAAAAAAAAAAAAAAAAAAAAAAAAAAAAAAAAAAAAAAAAAAAAAAAAAAAAAAAAAAAAAAAAAAAAD   2    EGAAAAAAAAAAAAAAAAAAAAAAAAAAAAAHBBBBBBF     2    EBBBBBBBBBBBBBBBBBBBF      2                                        u C
AAAAAAAAAAAAAAAAAAAAAAAAAAAAAAAAAAAAAAAAAAAAAAAAAAAAAAAAAAAAAAAAAAAAAAAAAAAAAAAAAAAAAAAAAAAAAAAAAHBBBBBBBBGAAAAAAAAAAAAAAAAAAAAAAAAAAAAAAAAAAAAAHBBBBBBBBBBGAAAAAAAAAAAAAAAAAAAHBBBBBBBBBBBBBBBBBBBBBBBBBBBBBBBBBBBBBBBBBBBBBBBBBG