cenario:3
D                                                                                                                                                                                                                                  C
D                                                                                                                                                                                                                         2       2C
D                                                                                                                                                                                                                         I 2    IIC
D                                                                                                                                                                                                                           I      C
D                                                                                                                                                                                                                             I    C
D                                                                                                                              o o                                                           8                                     C
D                                                                               8                                              o                  8                                    EBBBBBBBBBBBBBBBBBBBBBBBBBF          ooo    C
D                                   o o o o o   1             1            o o o o             1                 2       o       o       o                             1      EBBBBBBBBGAAAAAAAAAAAAAAAAAAAAAAAAAHBBBBF        o ! C
D    #      EBBBBBBBBBBF                                                                                         EBBBBBBBBBBBBBBBBBBBBBBBBBBBBBBBBBBBBBBBBBBBBBBBBBBBBBBBBBBBBGAAAAAAAA                          AAAAAHBBBBBF   EBBG
HBBBBBBBBBBBGAAAAAAAAAAHBBBBBBBBBBBBBBBBBBBBBBBBBBBBBBBBBBBBBBBBBBBBBBBBBBBBBBBBBBBBBBBBBBBBBBBBBBBBBBBBBBBBBBBBBGAAAAAAAAAAAAAAAAAAAAAAAAAAAAAAAAAAAAAAAAAAAAAAAAAAAAAAAAAAAAAAAAAAAAA     3    o o o o o    3      AAAAAAAD   CAAA
AAAAAAAAAAAAAAAAAAAAAAAAAAAAAAAAAAAAAAAAAAAAAAAAAAAAAAAAAAAAAAAAAAAAAAAAAAAAAAAAAAAAAAAAAAAAAAAAAAAAAAAAAAAAAAAAAAAAAAAAAAAAAAAAAAAAAAAAAAAAAAAAAAAAAAD                                                                         CAAA
AAAAAAAAAAAAAAAAAAAAAAAAAAAAAAAAAAAAAAAAAAAAAAAAAAAAAAAAAAAAAAAAAAAAAAAAAAAAAAAAAAAAAAAAAAAAAAAAAAAAAAAAAAAAAAAAAAAAAAAAAAAAAAAAAAAAAAAAAAAAAAAAAAAAAAD  *                         1                  1                   1     CAAA
AAAAAAAAAAAAAAAAAAAAAAAAAAAAAAAAAAAAAAAAAAAAAAAAAAAAAAAAAAAAAAAAAAAAAAAAAAAAAAAAAAAAAAAAAAAAAAAAAAAAAAAAAAAAAAAAAAAAAAAAAAAAAAAAAAAAAAAAAAAAAAAAAAAAAAHBBBBBBBBBBBBBBBBBBBBBBBBBBBBBBBBBBBBBBBBBBBBBBBBBBBBBBBBBBBBBBBBBBBBBBBBBGAAA