cenario:4
D                                                                                                                                                                                                                                                                                   CA
D                                                                                                                                                                                                                                                       I       2                   CA
D                                                                                                                                                                                                                                                       I       IIIIIIIIII          CA
D                                           2  o                                                                                                                                                                                                        I      I         I          CA
D                                      2IIIII                                                                                                                                                                                                           I *   I            I     I  CA
D                                     IIIIIII  o                     o                                                                                                                                                                                  IIIIII                      CA
D                                    IIIIIIIIIIIIIII                  o o                                                   o  o                                                                                                                                        o         I CA
D                                   IIIIIIIIIIIIIIII   o             o o o                                                  o  o                                    o  o                                                                    3                          o o   EBBBBBBGA
D                                 2IIIIIIIIIIIIIIIII               IIIIIIIII                              EBBBBBBBBBF                                               o  o                                                         oo  oo                                      CAAAAAAAA
D                                 IIIIIIIIIIIIIIIIII              IIIIIIIIIII                            EGAAAAAAAAAD    1   1   2                                  o  o                                                3      oo      oo                            EBBBBBBBGAAAAAAAA
D                      3         IIIIIIIIIIIIIIIIIII   o                           EBBBF                EGAAAAAAAAAAHBBBBBBBBBBBBBBBBBBBBBBBBBBBBBBBBBBBBBBBBF      o  o                                                     oo  oo  oo  oo                          CAAAAAAAAAAAAAAAA
D  #                            IIIIIIIIIIIIIIIIIIII              2    1    1      CAAAD       oooo o1o CAAAAAAAAAAAAAAAAAAAAAAAAAAAAAAAAAAAAAAAAAAAAAAAAAAAAD       oo  2    EBBBBBBBBBBBBF              EBBBBBBBBBBBF                             2     2          CAAAAAAAAAAAAAAAA
DBBBBBBBBBBBBBBBBBBBBBBBBBBBBBBBAAAAAAAAAAAAAAAAAAAHBBBBBBBBBBBBBBBBBBBBBBBBBBBBBBBGAAAHBBBBBBBBBBBBBBBBGAAAAAAAAAAAAAAAAAAAAAAAAAAAAAAAAAAAAAAAAAAAAAAAAAAAAHBBBBBBBBBBBBBBBBGAAAAAAAAAAAAHBBBBBBBBBBBBBBGAAAAAAAAAAAHBBBBBBBBBBBBBBBBBBBBBBBBBBBBBBBBBBBBBBBBBBBBBBGAAAAAAAAAAAAAAAA