cenario:2
D                                                                                                                                                                                                                          CAAAAAAAAD       C
D                                                                                                                                                                                                                          CAAAAAAAAD       C
D                                                                                                                                                                                                                          CAAAAAAAAD       C
D                                                                                                                                                                                                                          CAAAAAAAAD    2 *C
D                                  1            2                                                                                                                                                                          CAAAAAAAAD     IIC
D                             IIIIIIIIIIIIIIIIIIIIIII                                                                                                                                                                      CAAAAAAAAD 2  I  C
D               IIIIIIIIIIIIIII                                                                        o o                                                                                                                 CAAAAAAAADII     C
D                                                       o o o                                         o                                                      EBBBBBBBBBBBBBBBBF                                            CAAAAAAAAD  I    C
D    #        0 o o 1 o o                1            o o o o           2                   2       o       o       o      2                      1     EBBBBGAAAAAAAAAAAAAAAAD         o    o    2    2          oooooooooCAAAAAAAAD      2C
HBBBBBBBBF  EBBBBBXYYYZBBBBBBBBBBBBBBBBBBBBBBBBF       EBBBBBBBBBBBBBBBBBBBXYYYZBBBBBBBBBBBBBBBBBBBBBBBBBBBBBBBBBBBBBBBBBBBBBXYYYZBBBBBBBBXYYYZBBBBBBBBGAAAAAAAAAAAAAAAAAAAAAHBBBBBBBBBBBBBBBBBBBBBBBBBBBBBBBBBF           CAAAAAAAAD    IIIC
AAAAAAAAAD EGAAAAAAAAAAAAAAAAAAAAAAAAAAAAAAAAAAD       CIIIIIIIIIIIIIIIIIIIIIIIIIIIIIIIIIIIIIIIIIIIIIIIIIIIIIIIIIIIIIIIIIIIIIIIIIIIIIIIIIIIIIIIIIIIIIIIIIIIIIIIIIIIIIIIIIIIIIIIIIIIIIIIIIIIIIIIIIIIIIIIIIIIIIIIIII    IID  CAAAAAAAAD   I   C
AAAAAAAAAD CAAAAAAAAAAAAAAAAAAAAAAAAAAAAAAAAAAAD                                                                                                                                                                      IID  CAAAAAAAAD       C
AAAAAAAAAD CAAAAAAAAAAAAAAAAAAAAAAAAAAAAAAAAAAAD                                                                                                                                                                     IIID  CAAAAAAAADII     C
AAAAAAAAAD CAAAAAAAAAAAAAAAAAAAAAAAAAAAAAAAAAAAD                                                                                                                                                                 IIIIIIID  IIIIIIIIII  I    C
AAAAAAAAAD CAAAAAAAAAAAAAAAAAAAAAAAAAAAAAAAAAAAD                                                                                                                                                                 IIIIIIID                   C
AAAAAAAAAD CAAAAAAAAAAAAAAAAAAAAAAAAAAAAAAAAAAAD                                                                                     3                                                         3             u  IIIIIIIID                 IIC
AAAAAAAAAD CAAAAAAAAAAAAAAAAAAAAAAAAAAAAAAAAAAAD               o               o                                                                                                                             IIIIIIIIIIID                   C
AAAAAAAAAD CAAAAAAAAAAAAAAAAAAAAAAAAAAAAAAAAAAAD               2                   2   ooooooooooooo                                                   ooooooooooooo                                         IIIIIIIIIIID                   C
AAAAAAAAAD CBBBBBBBBBBBBBBBBBBBBBBBBBBBBBBBBBBBBBBBBBBBBBBBBBBBBBBBBBBBBBBBBBBBBBBBBBBBBBBBBBBBBBBBBBBBBBBBBBBBBBBBBBBBBBBBBBBBBBBBBBBBBBBBBBBBBBBBBBBBBBBBBBBBBBBBBBBBBBBBBBBBBBBBBBBBBBBBBBBBBBBBBBBBBBBBBBBBBBBBBBBBBHBBBBBBBBBBBBBBBBBBBG