cenario:4
D                                                                                                                                                                                                                                           C
D        3                                                                                                                                                                                                                                  C
D                                                                                                                                                                                                                                           C
D                            IIIIIIIIIIIIII    2                                                                                                                                                                                            C
D                           I              I  II 2                                                                                                                                                                                          C
D                          I                    IIII   2                II                                                                                                                                                                  C
D           I IIIIIIIIIIIII                        IIIIIIIIIIIIIIIIIII    I o o oo o oo o o               o o o o o                                                                                                                         C
D          II                                                              IIIIIIIIIIIIIIIIIIII  I        IIIIIIIIIIIIII                                                                                                                    C
D         I I             3                     1      2      1                                   I      I                                                                                  IIIIII                                          C
D        I  I                             IIIIIIIIIIIIIIIIIIIIIII                                  I    I                                                  2                                                                                C
D       I   I               IIIIIIIIIIIIIII                                                         I  I            o o              3                 IIIIIIIIII                2                                                          C
D      I    I              I                                         o o o                                          o                                                     EBBBBBBBBBBBBBBBBBB      BF          ooo                          C
D           I             I u o o o o o                1            o o o o                               2       o       o       o     #                       1     EBBGAAAAAAAAAAA            CBHBBBF         o    o         2   ! u     C
D *         EBBBBBBBBF  EBBBBBBBBBBBBBBBBBBBBBBBBBBBBBBBBBBBBBBBBBBBBBBBBBBBBBBBBBBBF         EBBBBBBBBBBBBBBBBBBBBBBBBBBBBBBBBBBBBBBBBBBF   EBBBBBBBBBBBBBBBBBBBBBBBBBGAAAAAAAAAAAAA          CBAAAAAAAHBBBBBBBBBBBBBBBBBBBBBBBBBBBBBBBBBBBG
HBBBBBBBBBBBGAAAAAAAAD EGAAAAAAAAAAAAAAAAAAAAAAAAAAAAAAAAAAAAAAAAAAAAAAAAAAAAAAAAAAAD         CAAAAAAAAAAAAAAAAAAAAAAAAAAAAAAAAAAAAAAAAAAD   CAAAAAAAAAAAAAAAAAAAA   AAAAAAAAAAAAAAAA        CBAAAAAAAAAAAAAAAAAAAAAAAAAAAAAAAAAAAAAAAAAAAAAA
AAAAAAAAAAAAAAAAAAAAAD CAAAAAAAAAAAAAAAAAAAAAAAAAAAAAAAAAAAAAAAAAAAAAAAAAAAAAAAAAAAAD        EGAAAAAAAAAAAAAAAAAAAAAAAAAAAAAAAAAAAAAAAAAAD  EGAAAAAAAAAAAAAAAAAAAA   AAAAAAAAAAAAAAAA      CBAAAAAAAAAAAAAAAAAAAAAAAAAAAAAAAAAAAAAAAAAAAAAAAA
AAAAAAAAAAAAAAAAAAAAAD CAAAAAAAAAAAAAAAAAAAAAAAAAAAAAAAAAAAAAAAAAAAAAAAAAAAAAAAAAAAAD       EGAAAAAAAAAAAAAAAAAAAAAAAAAAAAAAAAAAAAAAAAAAAD                o                              CBAAAAAAAAAAAAAAAAAAAAAAAAAAAAAAAAAAAAAAAAAAAAAAAAAA
AAAAAAAAAAAAAAAAAAAAAD CAAAAAAAAAAAAAAAAAAAAAAAAAAAAAAAAAAAAAAAAAAAAAAAAAAAAAAAAAAAAD   !  EGAAAAAAAAAAAAAAAAAAAAAAAAAAAAAAAAAAAAAAAAAAAAD                o   o o o o o o o o o   u u  CBAAAAAAAAAAAAAAAAAAAAAAAAAAAAAAAAAAAAAAAAAAAAAAAAAAAA
AAAAAAAAAAAAAAAAAAAAAD CAAAAAAAAAAAAAAAAAAAAAAAAAAAAAAAAAAAAAAAAAAAAAAAAAAAAAAAAAAAAHBBBBBBGAAAAAAAAAAAAAAAAAAAAAAAAAAAAAAAAAAAAAAAAAAAAAHBBBBBBBBBBBBBBBBBBBBBBBBBBBBBBBBBBBBBBBBBBBBBGAAAAAAAAAAAAAAAAAAAAAAAAAAAAAAAAAAAAAAAAAAAAAAAAAAAAA